00000000000000000000110000
00000000000000000000000000
00114444002200110000000000
00114444002200110000000000
00004444113333334444002200
00004444113333334444002200
00000000003333334444110000
00000000003333334444110000
00220000444400330000000000
00220000444400330000000000
33331100444422000000001100
33331100444422000000001100
33333300000000000022000022
33333300000000000022000022
00114444001100000000000000
00114444001100000000000000
22004444333344443333001100
22004444333344443333001100
00000000330044443333444400
00000000330044443333444400
00000022330000003333444400
00000022330000003333444400
00001100110000000000000000
00001100110111100000000000
11000000000100100011220000
11000000000100100011220000